ala: valisova
anj: argajova, belajova, danisovsky, deak, deakova, faixova, hrbata, jamborova, kabatova, kucharova, lichvarova, lindbloom, minarikova, mistrik, molnarovaxb, molnarovaxz, pelica, pochova, reiling, repasky, sedlackova, seitsinger, smrekova, tarasovic, varga
ant: banovsky, lindbloom, schnapp
apebio: bendikova, iliasova, kascakova, slusny
apeche: belickova, bendikova, buckova, krizanova, monosikova
apefyz: chalupkova, elizerova, gondova, letanovska, matasovska
bio: bendikova, iliasova, kascakova, krizanova, lanator, oravec, slusny, trupova
che: belickova, bendikova, buckova, krizanova, malik, monosikova, oravec
cvm: kosutova
das: matuskova, slezak
deg: machalova
dej: deak, kindji, matuskova, mlynarcikova, slezak, vanca
deu: michalovicova
eko: kolnikova, reiling, siller
esi: suchterova
etv: belajova, capuchova, hrbata, hrenakova, karacsonyova, kmet, mistrik, nemcokova, oravec, pochova, sartorisova, sirotna, sorfova, trupova, varga, vargova, zahorska
frj: molnarovaxz
fyz: chalupkova, elizerova, galik, gonda, gondova, letanovska, matasovska
geg: ambrozy, gunisovaxc, kindji, markusova, trupova
huv: Belajova, crmoman, hrbata, hubickova, jancovicova, pochova, sedlackova
inf: bakosova, bertova, bezakova, cikatricisiova, hubickova, jancovicova, kosut, laucekova, lomen, pelica, repasky, seitsinger, svitekova, winczer
kaj: lichvarova, minarikova, valisova, varga
mat: ambrozy, belajova, chalupkova, gradzka, gunisovaxc, hubickova, jancovicova, kocy, kocy, kosper, kosut, kosutova, machalova, matasovska, neuhold, pelica, pochova, sedlackova, seitsinger, svitekova, valaskova, zorkocy
matasovska: HUV
nbv: jakubec
nej: chrastinova, jozova, mayer, vaskova, zajacova
obn: banovsky, deakova, vanca
paj: tarasovic
pcp: bertova, lomen, neuhold
pos: hrobar
psy: ditte, sartorisova
rak: jamborova, valisova
seb: kascakova, krizanova
sech: buckova, malik, monosikova
sed: matuskova, slezak
sef: elizerova, letanovska
seg: ambrozy
sem: ambrozy, chalupkova, kosper, kosut, kosutova, matasovska
sen: liska, lomen
sja: krskova, patoprsta, sartorisova, zahorska
sjl: belajova, hrapkova, hrbata, hrenakova, hubickova, hvojnikova, jancovicova, michalovicova, minarikova, orenicova, peckova, pochova, sedlackova, sorfova, suchterova, vicenova
spg: cikatricisiova, kosut
sps: deakova, vanca
tev: argajova, belajova, fedak, hasko, horvathova, hrbata, luptak, luptakova, pavlovicsova, pochova, sedlackova, vargova
thd: kmet, masarova
tok: banovsky, kindji
tsv: danisovsky, fedak, hasko, horvathova, luptak, luptakova, pavlovicsova, sirotna, smrekova
ukl: crmoman, masarova, michalovicova
ved: belajova, gondova, hrbata, hubickova, jancovicova, pelica, pochova, sedlackova, seitsinger, svitekova, orenicova
vso: hubickova, jancovicova, pelica, seitsinger, svitekova
vyu: dzuriakova, jancovicova, kmet, orenicova, pelica
vyv: belajova, hrbata, masarova, pochova, sedlackova
