mat: ambrozy, belajova, chalupkova, gradzka, gunisovaxc, hubickova, jancovicova, kocy, kocy, kosper, kosut, kosutova, neuhold, pelica, pochova, sedlackova, seitsinger, svitekova, valaskova, zorkocy
geg: ambrozy, gunisovaxc, kindji, trupova
sem: ambrozy, chalupkova, kosper, kosut, kosutova
seg: ambrozy
tev: argajova, belajova, fedak, hasko, horvathova, hrbata, luptak, luptakova, pavlovicsova, pochova, sedlackova, vargova
anj: argajova, belajova, danisovsky, deak, deakova, faixova, hrbata, jamborova, kabatova, kucharova, lichvarova, lindbloom, minarikova, mistrik, molnarovaxb, molnarovaxz, pelica, pochova, reiling, repasky, sedlackova, seitsinger, smrekova, tarasovic, varga
inf: bakosova, bertova, bezakova, cikatricisiova, hubickova, jancovicova, kosut, laucekova, lomen, pelica, repasky, seitsinger, svitekova, winczer
tok: banovsky, kindji
obn: banovsky, deakova, vanca
ant: banovsky, lindbloom, schnapp
etv: belajova, capuchova, hrbata, hrenakova, karacsonyova, kmet, mistrik, nemcokova, oravec, pochova, sartorisova, sirotna, sorfova, trupova, varga, vargova, zahorska
sjl: belajova, hrapkova, hrbata, hrenakova, hubickova, hvojnikova, jancovicova, michalovicova, minarikova, orenicova, peckova, pochova, sedlackova, sorfova, suchterova, vicenova
ved: belajova, gondova, hrbata, hubickova, jancovicova, pelica, pochova, sedlackova, seitsinger, svitekova
huv: belajova, crmoman, hrbata, hubickova, jancovicova, pochova, sedlackova
vyv: belajova, hrbata, pochova, sedlackova
che: belickova, bendikova, buckova, krizanova, monosikova, oravec
apeche: belickova, bendikova, buckova, krizanova, monosikova
bio: bendikova, iliasova, kascakova, krizanova, lanator, oravec, slusny, trupova
apebio: bendikova, iliasova, kascakova, slusny
pcp: bertova, lomen, neuhold
sech: buckova, monosikova
fyz: chalupkova, elizerova, galik, gonda, gondova, letanovska
apefyz: chalupkova, elizerova, gondova, letanovska
nej: chrastinova, jozova, vaskova, zajacova
spg: cikatricisiova, kosut, markusova
ukl: crmoman, michalovicova
tsv: danisovsky, fedak, hasko, horvathova, luptak, luptakova, pavlovicsova, sirotna, smrekova
dej: deak, kindji, mlynarcikova, slezak, vanca
sps: deakova, vanca
psy: ditte, sartorisova
vyu: dzuriakova, jancovicova, kmet, orenicova, pelica
sef: elizerova, letanovska
pos: hrobar
vso: hubickova, jancovicova, pelica, seitsinger, svitekova
nbv: jakubec
rak: jamborova, valisova
seb: kascakova, krizanova
thd: kmet
eko: kolnikova, reiling, siller
cvm: kosutova
sja: krskova, patoprsta, sartorisova, zahorska
kaj: lichvarova, minarikova, valisova, varga
sen: liska, lomen
MAT: machalova, matasovska
DEG: machalova
CHE: malik
SECH: malik
INF: malik
GEG: markusova
VYV: masarova
UKL: masarova
THD: masarova
SEM: matasovska
APEFYZ: matasovska
FYZ: matasovska
SED: matuskova
DEJ: matuskova
DAS: matuskova
NEJ: mayer
deu: michalovicova
frj: molnarovaxz
hubv: orenicova
sed: slezak
das: slezak
esi: suchterova
paj: tarasovic
ala: valisova